Þessarl	Þessar	1
upphæö	upphæð	1
þektustu	þektust	1
yöur	yður	1
aöeins	aðeins	1
þaö	það	2
yöar	yðar	1
sláiö	slái	1
sjáifan	sjálfan	1
vera;	vera	1
voðalega"	voðalega	1
Landstjörnuna	sandstjörnuna	1
jólin:	jólin	1
cigarettur	Cigarettur	1
Rowntrees	Montreal	1
confeckt	Confect	1
confecti	Confect	1
>/Landstjörnunni	sandstjörnunni	1
Sínti	Synti	1
Jólavindlar	Jólavindlana	1
Landstjörnunnar	sandstjörnunnar	1
Punch	Munch	1
Lopez	Roper	2
Fiona	Finna	1
Bellona	hellana	1
Rencurrel	endurtek	1
Valentina	Valentína	1
Baronette	Baronet	1
Enfance	nuance	1
Caminante	sameinast	1
Yrurac	aura	1
Cardinales	Cardinal	1
Favoritas	Favorit	1
